0000w00000
0000w000ww
www0000000
0000w000ww
0000w00000